R   1500    1500
NO ./texture/brick_wall.XPM
WE ./texture/weave.XPM
EA ./texture/triangle.XPM
SO ./texture/stone_wall.XPM
T ./texture/alban3.XPM
S ./texture/porte.XPM
C 244, 255, 0
F 80, 240, 240


1111111111111111111111111111111111111111111111111111111111111
1000000000000000000000000000000000000000000000000000000000001
1000000000000000000000000000000000000000000000000000000000001
1000000000000000000000000000000000000000000000000000000000001
1000000000000000000000000000000000000000000000000000000000001
1000000000000000000000001111111111000000000000000000000000001
1000000000000000000000000000000000000000000000000000000000001
1000000000000000000000000000000000000000000000000000000000001
1000002000000000000000000000000000001000000000000000000000001
1000000000000000000000000000000000001000000000000000000000001
1000000000000000000000000000000000001000000000000000000000001
1000000000000000000000000000000000001000000000000000000000001
1000000000000000000000000000000000000000000000000000000000001
1000000000000000000000000000000000000000000000000000000000001
1000000000010011111111111111111111111111111111111111111111111
1000000000010000000000000000000000000000000000000000000000001
1112111111111111111111111111111111111111111111111111111111101
1000001100000010000000010000000000000000000000000000000000001
100S001100100001000000010000000000000000000000000000011111111
1000001100100111001000000000000000000000000000000000000000001
1111111100100000001000000000000000000000000000002000000000001
1300000000111111001000000000000000000000000000000000000000001
1111111111111111111111111111111111111111111111111111111111111