R 200  200
NO    ./texture/brick_wall.XPM
WE   ./texture/weave.XPM
EA   ./texture/triangle.XPM
SO  ./texture/stone_wall.XPM


C     244,   255,    80
F     80,   240,       240

11111111
1N000011
10001001
11000001
11111111